----------------------------------------------------------------------------------X-----------------
----------------------------------------------------------------------------------X-----------------
----------------------------------------------------------------------------------X-----------------
----------------------------------------------------------------------------------X-----------------
----------------------------------------------------------------------------------X-----------------
--------------------------------------------------------------------------XX------X------SSQ--------
-------------------------------------------------------------------------XXX------X-----------------
------------------------------------------------------------------------XXXX------X-----------------
-----------------------------------------------------------------------XXXXX------X--S------------}-
SS------------------<>------------------------XX--X-------------------XXXXXX------X--------S-----<>-
--------------------[]-----------------------XXX--XX-----------------XXXXXXX------X--------------[]-
-------<>-----------[]----------------------XXXX--XXX------------<>-XXXXXXXX------X--------------[]-
-{-----[]-----------[]---------------------XXXXX--XXXX------X----[]XXXXXXXXX------X---------E-EE-[]-
XXXXXXXXXXXXXXXXXXXXXXXXX---------------XXXXXXXX--XXXXXXXXXXXXXXXXXXXXXXXXXXXXXXXXXXXXXXXXXXXXXXXXXX
